0 0 0 0 0 0 0 0 0 0 0 0 0 0 0 0 0 0 0 0
6 6 0 8 7 0 0 7 0 0 0 0 0 0 0 0 0 0 0 0
7 6 0 8 2 4 4 2 0 0 0 0 0 0 0 0 0 0 0 0
0 6 0 8 0 2 2 0 0 0 0 0 0 0 0 0 0 0 0 4
0 6 0 8 0 0 0 0 0 0 0 0 0 0 0 0 8 7 7 7
0 6 0 8 0 0 0 0 0 0 0 0 0 0 0 0 8 0 6 2
6 6 6 7 7 7 7 6 6 2 6 6 7 7 7 7 6 6 6 2
6 6 6 2 2 2 2 6 6 6 6 6 2 0 0 2 6 6 6 2
6 6 6 2 2 2 2 6 6 6 6 6 2 5 0 2 6 6 6 2
6 6 6 2 2 2 2 6 6 6 6 6 2 2 2 2 6 6 6 2