0 0 0 0 0 0 0 0 0 0 0 0 0 0 0 0 0 0 0 0
0 0 0 0 0 0 0 0 0 0 0 0 0 4 0 0 0 4 0 0
0 0 0 0 5 0 0 0 0 0 0 0 0 0 0 0 7 7 8 0
0 0 4 7 7 7 0 0 0 0 0 0 0 0 0 0 0 0 8 0
0 0 0 0 0 0 0 7 0 4 0 0 0 0 0 0 0 0 8 0
0 0 0 0 0 0 0 0 0 7 0 0 0 0 0 0 0 0 8 0
0 0 0 0 0 0 0 0 0 0 0 7 7 0 0 0 0 4 8 0
0 0 0 0 0 0 0 0 0 0 7 2 2 6 6 6 7 7 7 7
6 6 7 0 0 0 9 0 0 7 2 2 2 6 6 6 6 6 6 2
6 6 2 7 7 7 7 7 7 2 2 2 2 6 6 6 6 6 6 2
