0 0 3 3 3 3 3 3 3 3 3 3 3 3 3 3 3 3 3 0
0 0 3 3 3 3 3 3 3 3 3 3 3 3 3 3 3 3 3 0
0 5 0 0 0 0 0 0 0 1 0 0 0 0 0 0 0 0 3 0
0 1 1 0 0 0 0 0 0 2 0 0 0 0 0 0 0 0 3 0
0 0 0 0 0 0 0 0 0 2 0 0 0 0 0 0 0 0 3 0
0 0 0 0 0 0 0 0 0 2 0 0 0 0 0 0 0 0 3 0
1 1 1 1 1 1 1 1 1 2 1 9 0 9 0 9 0 1 3 1
2 2 0 0 2 2 2 0 0 0 0 1 1 1 1 1 2 2 3 2
2 2 4 4 4 4 4 4 9 4 4 4 4 4 4 4 4 4 3 2
2 2 2 2 2 2 2 2 2 2 2 2 2 2 2 2 2 2 2 2
